.**.....*
*.*.*...*
*.**.*...
....**..*
**.....**
.....*...
.....***.
....**...
........*
